6 2 0 2 5
2 3 1 1 2
0 2 4 2 0
1 0 0 0 1
0 1 0 1 0